[
  [
    [ "i", "1", "1", "1", "1", "1", "0", "9" ],
    [ "8", "2", "1", "4", "0", "1", "1", "0" ],
    [ "0", "1", "0", "0", "0", "0", "1", "0" ],
    [ "0", "1", "6", "0", "0", "7", "1", "0" ],
    [ "0", "1", "0", "0", "0", "0", "1", "3" ],
    [ "5", "1", "0", "0", "0", "0", "1", "0" ],
    [ "0", "1", "0", "0", "0", "0", "1", "0" ],
    [ "0", "3", "0", "0", "0", "0", "3", "0" ]
  ],
  [
    [ "9", "1", "1", "0", "0", "0", "1", "1" ],
    [ "0", "6", "1", "0", "4", "0", "1", "0" ],
    [ "3", "1", "0", "0", "0", "0", "0", "1" ],
    [ "0", "7", "1", "0", "0", "0", "1", "0" ],
    [ "3", "1", "0", "0", "0", "0", "2", "1" ],
    [ "0", "5", "1", "0", "0", "0", "1", "0" ],
    [ "3", "1", "0", "0", "0", "0", "0", "1" ],
    [ "0", "0", "0", "0", "0", "0", "8", "i" ]
  ],

  [
    [ "0", "0", "1", "1", "1", "1", "1", "1" ],
    [ "0", "4", "0", "1", "0", "0", "0", "1" ],
    [ "1", "0", "3", "0", "3", "0", "5", "1" ],
    [ "1", "1", "0", "0", "0", "1", "1", "i" ],
    [ "1", "0", "3", "0", "3", "0", "2", "8" ],
    [ "1", "0", "0", "1", "0", "0", "0", "1" ],
    [ "1", "0", "7", "1", "6", "0", "0", "0" ],
    [ "1", "1", "1", "1", "1", "1", "0", "9" ]
  ],
  [
    [ "i", "1", "2", "0", "7", "0", "1", "1" ],
    [ "8", "1", "1", "1", "1", "3", "0", "2" ],
    [ "0", "0", "0", "0", "0", "0", "1", "1" ],
    [ "0", "2", "0", "1", "0", "1", "2", "7" ],
    [ "3", "1", "3", "1", "0", "1", "0", "1" ],
    [ "5", "1", "7", "1", "3", "1", "3", "1" ],
    [ "0", "1", "0", "1", "0", "0", "0", "1" ],
    [ "0", "4", "0", "1", "9", "0", "6", "1" ]
  ]

]