[

	[
		[ "0", "7", "0", "1", "0", "0", "0", "4" ],
		[ "0", "0", "0", "0", "1", "7", "0", "0" ],
		[ "1", "0", "1", "0", "0", "1", "0", "3" ],
		[ "1", "0", "1", "0", "3", "2", "1", "0" ],
		[ "1", "0", "1", "0", "0", "1", "2", "0" ],
		[ "1", "2", "1", "1", "3", "0", "1", "0" ],
		[ "0", "0", "0", "1", "1", "0", "0", "0" ],
		[ "0", "9", "0", "8", "i", "1", "2", "0" ]

	],

	[
		[ "1", "1", "0", "1", "7", "0", "1", "1" ],
		[ "2", "3", "0", "3", "0", "0", "9", "1" ],
		[ "1", "0", "0", "1", "1", "1", "1", "1" ],
		[ "1", "0", "2", "1", "0", "4", "0", "1" ],
		[ "1", "0", "1", "1", "i", "1", "7", "1" ],
		[ "1", "0", "1", "2", "8", "1", "3", "1" ],
		[ "1", "0", "3", "0", "0", "0", "0", "1" ],
		[ "1", "1", "1", "0", "0", "0", "1", "1" ]
	],
	[
		[ "0", "9", "0", "0", "0", "0", "0", "2" ],
		[ "0", "1", "1", "1", "1", "1", "0", "1" ],
		[ "2", "1", "0", "0", "2", "1", "0", "1" ],
		[ "0", "1", "0", "4", "0", "1", "0", "1" ],
		[ "3", "1", "0", "1", "1", "1", "0", "1" ],
		[ "0", "1", "0", "0", "0", "3", "0", "1" ],
		[ "0", "1", "1", "8", "1", "1", "3", "1" ],
		[ "7", "0", "1", "i", "1", "1", "7", "1" ]
	],
	[
		[ "1", "0", "0", "0", "9", "0", "2", "1" ],
		[ "1", "0", "0", "0", "0", "0", "0", "1" ],
		[ "1", "3", "1", "1", "1", "1", "1", "1" ],
		[ "1", "0", "0", "0", "3", "0", "7", "1" ],
		[ "8", "0", "0", "0", "1", "0", "1", "1" ],
		[ "0", "1", "0", "2", "1", "0", "1", "0" ],
		[ "i", "1", "3", "1", "1", "3", "1", "0" ],
		[ "0", "1", "2", "4", "0", "7", "1", "0" ]
	],
	[
		[ "1", "1", "0", "1", "2", "0", "1", "1" ],
		[ "7", "3", "0", "3", "0", "0", "9", "1" ],
		[ "1", "0", "0", "1", "1", "1", "1", "1" ],
		[ "1", "0", "2", "1", "0", "4", "0", "1" ],
		[ "1", "0", "1", "1", "0", "1", "7", "1" ],
		[ "1", "3", "1", "2", "0", "1", "3", "1" ],
		[ "1", "0", "1", "0", "0", "0", "0", "1" ],
		[ "1", "0", "0", "0", "0", "0", "8", "i" ]
	]

]
