[

  [
    [ "1", "1", "0", "0", "0", "0", "3", "0" ],
    [ "5", "9", "0", "0", "0", "0", "1", "0" ],
    [ "1", "1", "1", "1", "1", "1", "1", "0" ],
    [ "2", "0", "0", "0", "0", "3", "0", "0" ],
    [ "0", "1", "3", "1", "8", "7", "1", "1" ],
    [ "0", "1", "6", "1", "i", "1", "7", "0" ],
    [ "0", "0", "1", "5", "1", "0", "0", "0" ],
    [ "2", "0", "0", "0", "3", "0", "0", "4" ]
  ],

  [
    [ "0", "0", "8", "i", "1", "5", "0", "5" ],
    [ "0", "9", "1", "1", "1", "0", "4", "0" ],
    [ "0", "0", "0", "5", "1", "0", "0", "0" ],
    [ "2", "0", "0", "7", "1", "2", "0", "0" ],
    [ "1", "1", "3", "1", "1", "1", "1", "3" ],
    [ "7", "3", "0", "0", "1", "6", "0", "0" ],
    [ "1", "1", "0", "0", "1", "0", "0", "0" ],
    [ "2", "3", "0", "0", "3", "0", "0", "6" ]
  ]

]