[

  [
    [ "1", "0", "1", "2", "0", "3", "0", "0" ],
    [ "0", "4", "1", "0", "0", "0", "1", "6" ],
    [ "0", "6", "1", "1", "0", "0", "1", "0" ],
    [ "3", "1", "0", "i", "1", "9", "1", "0" ],
    [ "0", "0", "8", "1", "2", "1", "1", "0" ],
    [ "0", "2", "1", "0", "0", "3", "0", "3" ],
    [ "0", "1", "1", "0", "1", "1", "0", "0" ],
    [ "0", "0", "0", "0", "3", "7", "1", "0" ]
  ],
  [
    [ "0", "0", "4", "6", "0", "1", "0", "2" ],
    [ "2", "1", "0", "1", "0", "1", "0", "0" ],
    [ "0", "0", "0", "3", "0", "1", "3", "7" ],
    [ "0", "1", "0", "1", "0", "1", "0", "1" ],
    [ "0", "1", "1", "6", "1", "1", "0", "1" ],
    [ "3", "0", "0", "3", "0", "0", "3", "7" ],
    [ "1", "1", "1", "0", "1", "1", "0", "1" ],
    [ "i", "8", "2", "0", "0", "0", "0", "9" ]
  ],
  [
    [ "1", "1", "1", "1", "1", "1", "1", "1" ],
    [ "6", "1", "0", "0", "2", "0", "8", "i" ],
    [ "0", "3", "0", "1", "1", "3", "1", "1" ],
    [ "1", "1", "0", "4", "1", "0", "6", "1" ],
    [ "7", "1", "1", "1", "1", "3", "1", "1" ],
    [ "3", "0", "2", "0", "0", "0", "0", "1" ],
    [ "0", "0", "0", "1", "3", "1", "2", "1" ],
    [ "9", "0", "1", "7", "0", "1", "1", "1" ]
  ]
]